11111111111111111111111111111111111111111111111111111111111111111111111111111111
10000000000000000000000000000000000000011000000000000000000000000000000000000001
10000000000000000000000000000000000000011000000000000000000000000000000000000001
10000000000000000000000000000000000000011000000000000000000000000000000000000001
10000000000000000000000000000000000000011000000000000000000000000000000000000001
10000000000000000000000000000000000000011000000000000000000000000000000000000001
11111111111111111111111122221111111111111111111100001111111111111111111111111111
10000000000000000000000000000000000000011000001000000000000000000000000000000001
10000000000000000000000000000000000000011000001000000000000000000000000000000001
10000000000000000000000000000000000000011000001000000000000000000000000000000001
10000000000000000000000000000000000000011000001000000000000000000000000000000001
10000000000000000000000000000000000000011000001000000000000000000000000000000001
11111111111111111111110000000011111111111000001111111111111111111112222110000001
10000000000000000000000000000010000000011000000000000000000000000000000010000001
10000000000000000000000000000010000000011000000000000000000000000000000010000001
10000000000000000000000000000010000000011000000000000000000000000000000010000001
10000000000000000000000000000010000000011000000000000000000000000000000010000001
10000000000000000000000000000010000000011000000000000000000000000000000010000001
11222211111111111111111111111111111000011111111111111111111111111111111111222211
10000000000000000000000000000000000000011000000000000100000000000000000000000001
10000000000000000000000000000000000000011000000000000100000000000000000000000001
10000000000000000000000000000000000000011000000000000100000000000000000000000001
10000000000000000000000000000000000000011000000000000100000000000000000000000001
10000000000000000000000000000000000000011000000000000100000000000000000000000001
10000000100000011111111111111111111111111000000100000111111111111111111111000001
10000000100000010000000000000000000000000000000100000000000000000200000001000001
10000000100000010000000000000000000000000000000100000000000000000200000001000001
10000000100000010000000000000000000000000000000100000000000000000200000001000001
10000000100000010000000000000000000000000000000100000000000000000200000001000001
10000000100000010000000001000000111111111000000111111111100000000100000001000001
10000000100000010000000001000000100000000000000200000000100000000100000001000001
10000000100000010000000001000000100000000000000200000000100000000100000001000001
10000000111111110000000001000000100000000000000200000000100000000100000001000001
10000000100000010000000001000000100000000000000200000000100000000100000001000001
10000000100000010000000001000000111111111111111100000000100000000100000001000001
10000000200000010000000001000000100000011000000100000000100000000100000001000001
10000000200000010000000001000000100000011000000100000000100000000100000001000001
10000000200000010000000001000000100000011000000100000000100000000100000001000001
10000000200000010000000001000000100000011000000100000000000000000100000000000001
10000000100000010000000001000000100000011000000100000000000000000100000000000001
11111111100000010000000001000000100000011000000100000000000000000100000000000001
10000000000000010000000001000000100000011000000100000000000000000100000000000001
10000000000000010000011111122221100000011000000100000000111111111111111111000001
10000000000000010000010000000000100000011000000000000000100000000000000001000001
10000000000000010000010000000000100000011000000000000000100000000000000001000001
10000000000000010000010000000000100000011000000000000000100000000000000001000001
10000000000000010000010000000000100000011000000000000000100000000000000001000001
10000001111111110000010000000000100000011000000111111111100000000000000001000001
10000000000000000000010000000000100000011000000100000000100000000100000001000001
10000000000000000000010000000000200000011000000200000000100000000100000001000001
10000000000000000000010000000000200000011000000200000000100000000100000000000001
10000000000000000000010000000000200000011000000200000000100000000100000000000001
10000000000000000000010000000000200000011000000200000000100000000100000000000001
10000000000000000000010000000000100000011000000100000000100000000100000000000001
11111111111111111111111111111111112222111122221111111111111111111111111111111111
10000000000000000000000000000000000000011000000000000000000000000000000000000001
10000000000000000000000000000000000000011000000000000000000000000000000000000001
10000000000000000000000000000000000000011000000000000000000000000000000000000001
10000000000000000000000000000000000000011000000000000000000000000000000000000001
10000000000000000000000000000000000000011000000000000000000000000000000000000001
11111111111111111111111111111111111111111111111111111111111111111111111111111111