11111111111111111111111111111111111111111111111111111111111111111111111111111111
1                 1                    11                                      1
1                 1                    11                                      1
1                 1                    11                                      1
1                 1                    11                                      1
1                 1                    11                                      1
111111111111111111111111!2  11111111111111111111"D  1111111111111111111111111111
1                                      11     1                  1             1
1                                3     11 2   1                  1             1
1    D                                 11     1                  1  B          1
1                                      11     1                  1             1
1                                      11     1                  1             1
1111111111111111111111 "B     11111111111     11111111111111    111!3  11      1
1                             1        11                               1      1
1                             1        11                               1      1
1                             1  C     11                               1      1
1                             1        11                               1      1
1                             1        11                               1      1
11!4  11111111111111111111111111111    11111111111111111111111111111111111!5  11
1                                      11            1                         1
1                                      11            1                         1
1                                      11            1   4                     1
1                                      11            1                         1
1                                      11            1                         1
1       1 "A   11111111111111111111111111     1      111111111111111111111     1
1       1      1                        #     1                  !       1     1
1       1      1                    +     F   1                  6       1     1
1       1      1                              1                          1     1
1       1  5   1                              1                          1     1
1       1      1         1      111111111     11111111111  "?    1       1     1
1       1      1         1 "@   1       #     !         1        1       1     1
1       1      1         1      1    G        F    @    1        1       1     1
1       11111111         1      1                       1        1       1     1
1       1      1         1      1                       1        1       1     1
1       1      1         1      1111111111111111        1        1       1     1
1       !      1         1      1      11      1        1        1       1     1
1       8      1         1      1 ;    11  :   1        1        1       1     1
1              1         1      1      11      1        1        1       1     1
1              1         1      1      11      1                 1             1
1       1      1      ?  1      1      11      1  ">             1   8         1
111111111      1         1      1      11      1                 1             1
1              1         1      1      11      1                 1             1
1              1     111111!9  11      11      1        111111111111111111"C   1
1          6   1     1          1      11               1                1     1
1              1"G   1 >        1      11               1                1     1
1              1     1          1      11               1                1     1
1              1     1          1      11               1                1     1
1      111111111     1          !      11      1111111111                1     1
1                    1          :      11      1        1        1       1     1
1                    1                 11      !        1        1       1     1
1                    1                 11      ;    9   1        1             1
1                    1          1      11               1   A    1             1
1                    1          1      11               1        1             1
1                    1          1      11      1        1        1             1
1111111111111111111111111111111111!<  1111!=  1111111111111111111111111111111111
1                                      11                                      1
1                                  =   11  <                                   1
1                                      11                                      1
1                                      11                                      1
11111111111111111111111111111111111111111111111111111111111111111111111111111111
