11111111111111111111111111111111111111111111111111111111111111111111111111111111
1                                      11                                      1
1                                      11                                      1
1                                      11                                      1
1                                      11                                      1
1                                      11                                      1
111111111111111111111111222211111111111111111111    1111111111111111111111111111
1                                      11     1                  1             1
1                                      11     1                  1             1
1                                      11     1                  1             1
1                                      11     1                  1             1
1                                      11     1                  1             1
1111111111111111111111        11111111111     11111111111111    111222211      1
1                             1        11                               1      1
1                             1        11                               1      1
1                             1        11                               1      1
1                             1        11                               1      1
1                             1        11                               1      1
11222211111111111111111111111111111    11111111111111111111111111111111111222211
1                                      11            1                         1
1                                      11            1                         1
1                                      11            1                         1
1                                      11            1                         1
1                                      11            1                         1
1       1      11111111111111111111111111      1     111111111111111111111     1
1       1      1                               1                 2       1     1
1       1      1                               1                 2       1     1
1       1      1                               1                 2       1     1
1       1      1                               1                 2       1     1
1       1      1         1      111111111      1111111111        1       1     1
1       1      1         1      1              2        1        1       1     1
1       1      1         1      1              2        1        1       1     1
1       11111111         1      1              2        1        1       1     1
1       1      1         1      1              2        1        1       1     1
1       1      1         1      1111111111111111        1        1       1     1
1       2      1         1      1      11      1        1        1       1     1
1       2      1         1      1      11      1        1        1       1     1
1       2      1         1      1      11      1        1        1       1     1
1       2      1         1      1      11      1                 1             1
1       1      1         1      1      11      1                 1             1
111111111      1         1      1      11      1                 1             1
1              1         1      1      11      1                 1             1
1              1     111111222211      11      1        111111111111111111     1
1              1     1          1      11               1                1     1
1              1     1          1      11               1                1     1
1              1     1          1      11               1                1     1
1              1     1          1      11               1                1     1
1      111111111     1          1      11      1111111111                1     1
1                    1          1      11      1        1        1       1     1
1                    1          2      11      2        1        1       1     1
1                    1          2      11      2        1        1             1
1                    1          2      11      2        1        1             1
1                    1          2      11      2        1        1             1
1                    1          1      11      1        1        1             1
11111111111111111111111111111111112222111122221111111111111111111111111111111111
1                                      11                                      1
1                                      11                                      1
1                                      11                                      1
1                                      11                                      1
1                                      11                                      1
11111111111111111111111111111111111111111111111111111111111111111111111111111111